0000000000000000
S101110111011100
0101010101010100
0101010101010100
011101110111011Z
0000000000000000
0000000000000000