0000000000000000
0000000001111100
0011111111000100
0010000000000100
S110000000000100
000000000000011Z
0000000000000000