0000000000000000
0000000000000000
0000011111100000
0000010000100000
S11111000011111Z
0000000000000000
0000000000000000